6 5
######
#S#00#
#00#0#
#000E#
######